ABOVE	AH B AH V
BELOW	B IH L OW
BELOW(2)	B IY L OW
CONTINUE	K AH N T IH N Y UW
DANCE	D AE N S
DOWN	D AW N
FASTER	F AE S T ER
GO	G OW
HARDER	HH AA R D ER
I	AY
IT	IH T
LEFT	L EH F T
LIKE	L AY K
MEAN	M IY N
OF	AH V
OKAY	OW K EY
PRESS	P R EH S
RESET	R IY S EH T
RIGHT	R AY T
ROBOT	R OW B AA T
ROBOT(2)	R OW B AH T
SLOWER	S L OW ER
SOFTER	S AA F T ER
SOFTER(2)	S AO F T ER
STAY	S T EY
STOP	S T AA P
TEACH	T IY CH
TRAIN	T R EY N
UP	AH P
WILL	W IH L
WILL(2)	W AH L
YOU	Y UW
